San Francisco => Coruscant
Chicago => Tatooine
Atlanta => Alderaan
Montreal => Kashyyyk
Nueva York => Endor
Washington => Hoth
Londres => Naboo
Madrid => Kamino
Paris => Geonosis
Essen => Mustafar
Milan => Dagobah
San Petersburgo => Yavin
Los Angeles => Utapau
Miami => Jakku
Ciudad de Mexico => Chandrila
Bogota => Corellia
Lima => Sullust
Santiago de Chile => Ryloth
Buenos Aires => Mandalore
Sao Paulo => Dantooine
Lagos => Felucia
Kinshasa => Taris
Jartum => Nal Hutta
Johannesburgo => Lothal
Argel => Mon Cala
El Cairo => Kessel
Riad => Malachor
Estambul => Zeltros
Bagdad => Mygeeto
Moscu => Manaan
Teheran => Onderon
Karachi => Dathomir
Bombay => Hapes
Nueva Delhi => Rishi
Calcuta => Bakura
Madras => Wayland
Yakarta => Ilum
Bangkok => Eriadu
Hong Kong => Bothawui
Shanghai => Duro
Pekin => Ithor
Seul => Korriban
Tokio => Ahch-To
Osaka => Crait
Taipei => Exegol
Ho Chi Minh => Scarif
Manila => Iego
Sidney => Jedha